1 1 1 1 1 1 1 1 1 1 1 1 1 1 1 1 1
1 3 0 0 2 2 2 1 2 1 0 0 2 2 0 0 1
1 0 1 1 1 1 2 0 0 0 2 1 1 1 1 0 1
1 2 2 2 2 2 1 0 1 0 1 0 2 2 2 0 1
1 2 1 1 1 0 0 0 2 0 0 0 1 1 1 2 1
1 0 7 0 1 0 1 2 2 2 1 0 1 2 2 2 1
1 2 1 0 0 0 2 1 2 1 2 0 0 0 1 2 1
1 1 0 0 1 2 2 2 8 2 2 2 1 0 7 1 1
1 2 1 0 0 0 2 1 2 1 2 0 0 0 1 0 1
1 2 2 2 1 0 1 2 2 2 1 0 1 2 0 2 1
1 2 1 1 1 0 0 0 2 0 0 0 1 1 1 2 1
1 2 2 2 2 0 1 0 1 0 1 2 0 9 2 2 1
1 0 1 1 1 1 0 0 0 0 2 1 1 1 1 0 1
1 0 0 2 2 2 0 1 2 1 0 0 0 2 0 6 1
1 1 1 1 1 1 1 1 1 1 1 1 1 1 1 1 1

width=17
height=15->17x15
1=wall
0=grass
2=brick
3=player
4=balloom
5=oneal
6=evil bomber
7=portal
8=door
9=key