1 1 1 1 1 1 1 1 1 1 1 1 1 1 1 1 1 1 1 1 1 1 1 1 1 1 1
1 3 2 0 0 0 0 2 2 0 0 0 0 10 0 0 2 2 2 2 0 0 2 2 0 0 1
1 0 1 0 1 0 1 0 1 0 1 0 1 9 1 0 1 0 1 0 1 0 1 2 1 0 1
1 0 0 2 0 0 0 2 2 0 0 2 2 2 0 0 2 0 2 0 0 7 2 0 0 0 1
1 0 1 0 1 0 1 0 1 0 1 0 1 0 1 0 1 0 1 0 1 0 1 0 1 0 1
1 0 2 2 0 0 0 2 0 0 0 0 0 2 0 2 0 2 0 5 4 0 2 2 0 0 1
1 0 1 0 1 0 1 0 1 0 1 4 1 0 1 0 1 0 1 0 1 0 1 2 1 0 1
1 0 2 2 2 0 2 2 0 0 0 0 0 8 0 0 0 2 0 0 0 0 0 2 0 0 1
1 0 1 0 1 0 1 0 1 0 1 0 1 0 1 0 1 0 1 0 1 0 1 0 1 0 1
1 0 2 2 0 0 2 2 0 0 2 0 0 0 2 2 2 2 0 2 0 0 2 0 0 0 1
1 0 1 0 1 0 1 0 1 0 1 5 1 0 1 0 1 0 1 0 1 0 1 0 1 0 1
1 0 0 2 0 7 0 2 2 2 0 0 0 0 0 0 2 0 0 2 0 0 0 2 2 0 1
1 0 1 0 1 0 1 0 1 0 1 0 1 0 1 0 1 0 1 0 1 0 1 0 1 0 1
1 0 2 2 0 2 2 0 0 0 2 0 0 0 0 0 2 2 0 6 0 0 2 0 2 0 1
1 0 1 0 1 0 1 0 1 0 1 0 1 0 1 0 1 0 1 0 1 0 1 0 1 11 1
1 1 1 1 1 1 1 1 1 1 1 1 1 1 1 1 1 1 1 1 1 1 1 1 1 1 1

width=27
height=16->27x16
1=wall
0=grass
2=brick
3=player
4=balloom
5=oneal
7=portal
6=chasing enemy = doll
8=door
9=key
10=minvo = boss
11=ai bomber